._._._._._._._._._._.
|     |E        |   |
._. . . . . . . . . .
|                   |
. . ._. . . . . . . .
|                   |
._. . . . . . . . . .
|  M                |
. . . . . . . . . . .
|              T    |
. . . . . . . . . . .
|             |     |
. . ._. . . . . . . .
|                   |
. . . . . . . . . . .
|       |           |
. . . . ._. ._. ._. .
| |   |             |
. . . . . . . . . . .
| |         |       |
._._._._._._._._._._.