._._._._._.
|  M|     |
._. . . ._.
|     |  T|
. . . ._. .
|    E| | |
._. ._. . .
|     | | |
. . ._. . .
| |       |
._._._._._.