._._._._._. 
|E  |   | |
. . ._. . .
| |     | |
._. ._. . .
|   |  T  |
. . . . . .
|  M|   | |
._. . ._._.
|         |
._._._._._.
