._._._._._.
| |M     E|
._. ._. ._.
|         |
. ._._. . .
|         |
. . . . ._.
|T| |     |
._. . . . .
|     | | |
._._._._._.