._._._._._. 
|  E   M  |
._._._. . .
|       | |
. . . ._. .
|T  |   | |
._. . ._. .
|     |   |
._. . . . .
|   |   | |
._._._._._.