._._._._._._._. 
|             |
. . . ._. . . .
|      E|     |
. . . . . ._. .
|       |     |
. . . . . ._._.
|    M        |
. ._. . . . . .
|       |T    |
. . . . ._. . .
|   | | |     |
._. . ._. . . .
|         |   |
._._._._._._._.
