. . ._. . . . 
  |      E|   
. . . . . . . 
              
. . . . . . . 
  |           
._. ._. . . ._
              
. . . . . . . 
   M|   |     
. ._. . ._. . 
              
. . . . . . . 
   T|       | 
