. . ._. ._
| |M     E
._. ._. ._
          
. ._._. . 
          
. . . . ._
 T| |     
._. . . . 
|     | | 
