. . . . . . . . . . 
      |       |  M| 
. . . . . . . . . . 
                    
._. . . . . . . . . 
           T        
. . . . . . . . . . 
                    
. . . . . . . . . . 
                    
. . . . . . . . . . 
|         |         
. . . . . . . . . ._
                    
. . . . . . . . . . 
  |         |       
. . . . . . . . . ._
        |    E      
. . . . . . . . . . 
                    
