._. ._._. 
|E  |   | 
. . ._. . 
| |     | 
._. ._. . 
    |  T  
. . . . . 
   M|   | 
._. . ._._
          
