. . . . . . . . . . 
   M                
. . . . . . . . . ._
                    
. . . . . . . . . . 
    |               
. . . . . ._. . . . 
      |            E
. . . . . . . . . . 
                    
. . . . . . . . . . 
          |         
. . . . . . . . . . 
 T        |         
. . . . . . . . . . 
            |       
. . . ._. ._. . . ._
  |           |     
._._. . . . ._._. . 
  | |               
