. . . . . 
   E   M  
._._._. . 
|       | 
. . . ._. 
 T  |   | 
._. . ._. 
|     |   
._. . . . 
|   |   | 
