. ._. . . . . 
              
. . . ._. . . 
       E|     
. . . . . ._. 
|       |     
. . . . . ._._
     M        
. ._. . . . . 
        |T    
. . . . ._. . 
|   | | |     
._. . ._. . . 
          |   
