. . . . . . . . . . 
              |     
. ._. . . . . . . . 
  |            E    
. . ._. . . . ._. . 
                    
. ._. ._. . . . . . 
                    
. . . . . . . . . . 
      |       |   | 
. . ._._. . . . . . 
                    
. . . ._. . . . . . 
                    
. . . . . . . ._. . 
        |           
. . . . . . . . . . 
          |T        
. . . . . . . . . . 
|             |    M
